111111111111111
10001C0000C0001
101111110111101
1C000E0000C0001
101111111111101
10000C000000001
111111111011111
1C000C000C00001
101111100111101
10000C0000000C1
11111P111111111
111111111111111
111111111111111
111111111111111
111111111111111
111111111111111
