111111111111111
1C000000C000001
101111111111101
1C0000000000C01
1C1111111111011
10000000P000001
111111101111111
1C000C0000C0001
101111111111101
1000000C0000001
1E1111111111111
111111111111111