111111111111111111111111111111111111111
1P0000000000000111111110000000000000001
1C1111111111100000000000111111111111111
1C1000000000011111111111000000000000001
1C1001111111000000000000111111111111111
1C1001000000001111111110000000000000001
1C1111111111110000000000000000111111111
1C0000000000001111111111111111000000001
1C1111111111110000000000000000111111111
1C0000000000001111111111111110000000001
1C1111111111110000000000000000111111111
1C0000000000001111111111111110000000001
1C1111111111110000000000000000111111111
1C0000000000000001111111110000000000001
1C1111111111110000000000001111111111111
1C0000000000000000001111100000000000E11
111111111111111111111111111111111111111
