11111111
1CEP1111
11111111
11111111